5 5
a0 b4 c0 d0 e0 
f0 g3 h0 i4 j0 
k0 l7 m0 n6 o0 
p0 q6 r6 s5 t0 
u0 v0 w0 x1 y0 
